#separator:tab
#html:false
〜あげく	"""色々〜したけど、最終的に・・・。"" 色々努力したが、結局ダメだったという残念な気持ちが含まれる。"
「〜あげく」と「〜結果 / 〜末に 」の違い	「〜あげく」は悪い結果に対してのみ使うことができのに対して、「〜結果」や「〜末に」は後ろに来る結果の良し悪しに関係なく使うことができる。  例文  ❌ 二年浪人したあげく、医学部に合格できた。 ⭕️ 二年浪人した結果、医学部に合格できた。 ⭕️ 二年浪人した末に、医学部に合格できた。
〜あまり（に）	〜すぎて   程度がすごいことを表す。
あまりの〜に / あまりの〜で	とても〜すぎるので   程度がかなり高いので、〜という普通ではない結果になるという意味
〜以上は	〜なのだから、当然・・・。
〜一方で	①Xは〜だが、Yは〜（対比） ②ある面では〜だが、別の面では〜（並列）
〜以来	〜してから、今までずっと。
「〜以来」と「〜てからというもの」の違い	意味はほとんど同じ。   ただし、「〜以来」は名詞と接続することも、動詞のて形と接続することもできる。
〜上で	まず〜してから。   単に「前件が起こる→後件が起こる」ではなく、前件は後件が起こるための前提条件であることを表す。
〜上で	〜ために / 〜のに
〜上は	〜なのだから、当然・・・。
〜得る / 〜得ない	〜できる / 〜できない
〜折に	〜ときに / 〜の機会に
〜かいあって / 〜かいもなく	①〜の効果があって / 〜のおかげで ②〜の価値があって   大変だった、辛かったが〜したことで効果や成果が得られて、いい結果になったと言いたい時に使う。
〜限り	〜の限界まで / できるところのギリギリまで
〜限り	～する間はずっと / ～の状態が続く間はずっと
〜がたい	〜するのが難しい。 「能力的にできない」ということには使わない。  [一緒に使われる動詞] 信じる、許す、理解する、受け入れる、想像するなど
〜かと思うと / 〜かと思ったら	〜すると、すぐに 前の事象が起こった直後に、後の事象が起こる。
〜か〜ないかのうちに	"""～するのとほぼ同時に"" 前の事象が起こる直前で、後ろの事象が起こることを表す。"
「〜か〜ないかのうちに」と「〜たとたん」の違い	「〜か〜ないかのうちに」は動作やイベントが発生する直前を表す。一方で、「〜たとたん」は動作やイベントが発生した直後を表す。   よって、次のような場合は置き換えることができない。  置き換えできないケース： ⭕️ 電話を切ったとたん、またかかってきた。 ❌ 電話を切るか切らないかのうちに、またかかってきた。
〜かねない	〜してしまうかもしれない / 〜という悪い結果になる可能性がある   ある原因から悪い結果になる可能性がある。
〜かねる	"""〜できない"" 不可能を表し、硬い表現なのでビジネスで使われる場合が多い。   「かねる」は「～しようとしてもできない」、「〜するのが難しくできない」という気持ちが含まれており、婉曲的に断るときに使われる。"
〜かのようだ / 〜かのように	〜ように見える / 〜ように感じる   実際にはそうではないが〜のように見えたり感じたりすると言いたい時に使う。
〜からいうと / 〜からいって / 〜からいえば	〜を考えると / 〜から判断すると
〜からして	①１つの例を出して、その例が～なのだから、他も～であると言いたい時に使う。 ②〜から判断して
〜からすると / 〜からすれば	〜の立場で考えると
〜からといって	たとえ〜という理由があっても
〜気味	いつもと違って、少し〜の感じがする ネガティブな言葉として使われる。
文型１：〜きり	"""〜してから、そのままずっと"" ある行為が行われてから、その後繰り返されていないことを表す。"
文型２：〜きり	〜だけ
くせに / くせして	〜という立場・身分なのに   ・逆接を表す「〜のに」と似た表現だが、「〜のに」には不満の気持ちが含まれている。 ・「〜くせに」は相手を侮辱したり、非難する時にも使われる。 ・「くせして」はくだけた会話で使う。 ・「本当は嬉しいくせに」のように相手をからかう時にも使われる。
〜くらいなら	〜よりも、むしろ・・・のほうがいい。   話し手が「悪い」、「嫌だ」と思っていることを、他と比べる表現。
〜げ	〜そうだ / 〜そうな様子だ   人の気持ちを表す言葉について、「そのような様子である」と言いたい時に使われる。 目上の人の様子をいう時にはあまり使わない。
「〜げ」と「〜そうだ」の違い	「〜そうだ」が人の気持ちを表す言葉に接続する場合は、置き換えて使うことができるが、そうでない場合はできない。
〜ことだ	〜しなさい / 〜したほうがいい 〜するな / 〜しないほうがいい  助言や忠告をする時に使う表現。
〜ことだし	ので / から   軽い理由を表す言い方。
〜ことなく	〜ないで   硬い表現なので、日常的なことに使うと違和感のある文になる場合がある。 （例）私はコーヒーを飲むとき、砂糖を入れることなく飲みます。
〜ことだろう / 〜ことか	非常に〜だと感じる。   話し手が感情を込めて言う表現。
〜ことになると / 〜こととなると	～の話題になると / ～の話になると   〜の話題について話すと、ある人の態度が急に変わることを表す表現
〜ことに（は）	とても〜で
〜ざるを得ない	～しなければならない / どうしても〜する必要がある。   そのことはしたくないが、避けられない状況でどうしてもする必要があるということを表す。
次第	〜したらすぐに / 〜が終わったらすぐに
〜次第だ / 〜次第で	〜によって決まる
〜次第だ	〜わけだ / 〜という事情だ
〜末に	色々〜したけど、最終的に。
〜ずじまい	〜しないで終わる   「しようと思っていたことをしないまま、終わってしまった」と言いたい時に使う。
〜ずにはいられない / 〜ないではいられない	どうしても〜しないでいることはできない。/ どうしても〜してしまう。 身体的に我慢できない場合や、ものごとの様子や事情を見て、話し手の心の中で「〜したい」という気持ちが起こり、意志の力で抑えられない時に使う。
〜そうにない / 〜そうもない	できる可能性が低いことを表す。 話し手が状況から判断して言う表現。
〜だけあって / 〜だけのことはあって	〜ので、当然・・・だ。
「〜だけあって」と「〜だけに」の違い	①「〜だけに」はマイナスの評価の場合も使えるが、「〜だけあって」は使いにくい。   ②「〜だけに」は期待に反した結果にも使えるが、「〜だけあって」は使いにくい。
〜だけに	〜ので、もっと・・・だ。 / 〜ので、なおさら・・・だ。
〜だけまし	良いとは言えないが、他の状況よりかまだいい
〜たて	〜したばかりで   新しさ、新鮮さを強調する表現。プラスの意味で使われることが多い。
〜たものではない	とても〜できない
〜っこない	絶対に～ない / 〜はずがない   強い否定の表現で、話し言葉。 親しい間柄の人に対して使う。
〜つつ	けれども
〜つつ	〜ながら
〜つつある	だんだん〜ている。 書き言葉で使われる。動作や作用がある方向に変化していることを表す。
〜っぽい	①名詞 / い形容詞 + っぽい：～のように感じる / ～のように見える ②名詞 + っぽい：〜が多いと感じる ③動詞 + っぽい：〜しやすい / よく〜する ③メモ 性格について述べる時によく使います。
〜てこのかた	〜してから、今までずっと。 / 〜以来
〜てでも	〜という手段をとってでも   何としてでも、どんな手段を使って実現したいという強い気持ちが含まれる。
〜てならない	"""気持ちが抑えられないほど〜だ / ひどく〜だ"" 感情や感覚を表す言葉と接続することが多い。"
〜てはいられない	このままの状態を維持し続けることはできない   時間的に、あるいは精神的に余裕がない状態にあり、そうすることができないと言いたい時に使う。
〜てまで / 〜までして	〜のような極端な程度まで
〜てみせる	がんばって〜するつもりだ / 本当に〜するつもりだ   ①話し手の強い決意や覚悟を示す表現。 ②相手にわかるように何か具体的な行為を示す表現。
〜というものではない	〜とは言えない。部分否定の「〜わけではない」と同じ意味で使われる。
〜といった	〜のような   例を挙げるときに使う表現。
〜といったら	① 〜は 驚きや、感動した気持ちの程度を話題にするときに使う。   ② 〜について話すと N1といったらN2：N1と聞いたり、見たりすると、すぐにN2を連想する。
〜とか（で）	"""〜そうで"" 伝聞表現。断定した言い方を避けたい時にも使う。"
〜どころか	①実際に～とは違って・・・だ。（正反対）   ② 〜だけでなく 、・・・も 話し手の驚きや意外な気持ちを含む。
〜ところだった	もう少しで～になる可能性があった。/ ～という結果になったかもしれない。   実際にはなっていないが、そうなりそうであったことを言う時に使う。
「〜ばかりでなく」と「〜どころか」の違い	「〜どころか」は話し手の驚きや意外な気持ちが含まれるので、次のような例文では使えない。   ⭕️ 肉ばかりでなく、野菜も毎日食べるようにしています。 ❌ 肉どころか、野菜も毎日食べるようにしています。
〜どころではない / 〜どころじゃない	"""～はとてもできない / ～する時間がない"" 「～する余裕がない」、「〜の他にもっと大切なことがある」と強く否定したいときに使う表現。"
〜として〜ない	全く〜ない 否定の強調。
〜とともに	～すると、それに応じてだんだん ～が変化すると、・・・も一緒に変化する
〜となると / 〜となれば / 〜となったら	もしそうなったら   話し手の意見や評価を言う表現で、「〜」と仮定したら、状況は異なると言いたい時に使う。
〜とは	〜は〜という意味だ。
〜に越したことはない	常識的に考えて〜の方がいい。〜の方が安全だ。
〜にこたえて	〜を受け入れて  / 〜合うように   「相手の希望や要求、期待の通りにする、合うようにする」と言いたい時に使う。
〜に際して	〜するときに / 〜に先立ち   特別な何かをする始めるときに使う言葉。
〜に限って	①〜の場合だけ、絶対に〜ない。 ②〜の場合だけ、特にそうである / 運悪くそうなる。
〜に相違ない	きっと〜だ / 〜に間違いない   話し手が確信を持って述べる推量表現。
〜にて	〜で   ①場所 ②手段・方法 ③時間 ④原因・理由
〜のみならず	～だけでなく
〜っぱなし	〜したままだ すべきことがあるのに、しないでそのままの状態にしてしまうことを表す。
〜ぶる	（本当はそうではないのに）〜のように振る舞う
〜ないことには〜ない	～しなければ～ない   後件の条件が成立するには、前件の条件が成立しなければならないということを表す。
〜ないことはない / 〜ないこともない	〜という可能性があるかもしれない / 絶対に〜とは言えない   断定を避けるために使われる言い方。
〜ないで済む / 〜ずに済む	〜しなくてもいい / 〜なくても問題はない
〜ないでもない / 〜ないものでもない	全く〜ないわけではない / 場合によっては〜する
〜ないとも限らない	もしかしたら〜かもしれない / 絶対にそうだとは言えない
〜ながら	〜のに / 〜けれども 「〜ながら・・・」の「〜から当然予想されることとは違い、実際は・・・だ」と言いたい時に使う表現。
〜なんて	予想していなかった事実を見たり聞いたりした時の驚きや感慨を表す時に使う表現。 話し言葉で使われる。書き言葉では「〜とは」が使われる。
〜にあたって / 〜にあたり	〜するとき   特別な場面や重要な場面で使う。 使用場面の例：新学期、入学、卒業、就職、結婚、発表、試験など
〜に応じて	・～にあわせて ・前の事柄が変われば、それに合わせて後の事柄も変わる。
〜に限らず	～だけでなく、・・・ 「・・・」には「～」よりも広い意味の言葉が来る。
〜に限り	～にだけ特別に・・・する。
〜に加えて	〜だけでなく、さらに
〜先立って / 〜に先立ち	〜の前の準備として、必要なことをする 「卒業」や「留学」など特別な事に対して使う。
～にしたら / ～にすれば / ～にしてみたら / ～にしてみれば	～の立場に立って考えると
～にしては	～にふさわしくない / ～から予想される結果と違って・・・   その事実から当然考えられる姿とは違うことを表す表現。他の人を批判したり評価したりするときに使われる。自分自身のことにはほとんど使われない。
〜にすぎない	[意味：ただ〜だけだ] 質的・量的に程度の低さを強調する表現。
〜に沿って	〜にしたがって / 〜から離れないように
〜につき	〜のため、〜という理由で 看板や掲示物など通知文でよく使われる表現。硬い表現なので日常会話で使うことはほとんどない。
〜につけて	～すると、いつも同じ気持ちになる。
〜にともなって	[意味：Aが変化するとBも一緒に変化する。] 一方の変化とともに他方も変わることを表す。 社会的なことに使われることが多い。
〜にほかならない	〜以外のものではない /  絶対に〜だ
〜にも関わらず	〜のに   予想と違ったことに対する、話し手の驚き・不満・非難などの気持ちを表す。
〜に基づいて	〜を基礎にして / 〜を根拠に
〜ぬ	〜ない
〜ぬきにして / 〜ぬきで	〜を考慮に入れず / 〜を除いて
〜ぬく	最後まで頑張って〜する。
〜の上で / 〜上の	〜という点から考えると / 〜という方面で
〜ことだから	〜なのだからきっと 性格やいつもの行動から判断して〜だと述べる表現。
〜のもとで	〜の下で / 〜に頼って
〜ばかりか	〜だけでなく
〜ばかりだ	「ますます～していく」 物事が悪い方向に変化が進んで行くことを表す。
〜ばかりに	～ので / ～が原因で 話し手の後悔や残念な気持ちを表すことが多く、後ろの文には悪い結果が来る。   「～たいばかりに」や「～が欲しいばかりに」は「どうしても～したいので」という意味になる。
〜はさておき	〜のことは今は置いておいて
〜はともかく（として）	～は今は問題にしないで・・・だ。 ～について考える必要があるが、今は置いておいて・・・を優先させる。
〜ばまだしも / 〜ならまだしも	〜なら少しはいいが / 〜はまだ許容範囲であるが
〜はもとより・・・も	〜はもちろん
〜反面	一方で / 一つの面では〜であるが、別の面から見ると
〜まい	～しようと思わない 強い否定の意志を表す。そのため、主語は１人称となる。
〜まい	～ないだろう   話者の推量を表す。古い言い方で書き言葉的。 推量なので、第３人称も主語として使用可。
〜まま（に）	〜とおりに / 〜にしたがって
〜もかまわず	〜も気にしないで   「普通は気にすることだが、それを気にしないで」と言いたい時に使う。
〜もしない	全く〜しない   話し手の不満の気持ちを表す。
〜ものか / 〜ものですか	二度と〜ない / 決して〜ない   強い否定を表す
〜ものがある	なんとなく〜だと感じられる。
ものだ	ほんとうに～だなぁ   感心したり、驚いたりしたことを気持ちを込めていう言い方。
ものだ	本来そうだと思われることを表す。当然〜する。   物事の本来の性質や傾向などを表す。
ものだ	〜すべきだ   社会的常識としてそうすべきだと言いたいときに使う表現。
〜ものだから	～ので   理由を言うときの言い方で、「本当は〜したくなかったが、〜なので」と謝罪の意味を込めて言う時に使われる。
～ものなら	〜なら   実現が難しいものやことに対しての願望や期待を表す。後ろには「〜たい」や「〜みろ」、「〜て欲しい」など願望や命令を表す言葉が来る。
〜ものの	だけれども
〜もの / 〜もん / 〜だもん	〜から くだけた話し言葉。子供がよく使う。
〜やら〜やら	〜や〜など色々あるがその中の代表例を１つ２つあげる時に使う。いろいろあって大変だ、不満があるということに使われることが多い。
〜ようとしている	もうすぐ〜する / 間もなく〜する 物事が始まる、あるいは終わる直前を表す。
〜ようものなら	もし〜のようなことをしたら 万一〜のようなことをしたら、大変なことが起こるということを表す。
～を契機に / ～を契機として	〜をいい機会だと考えて / 〜をきっかけにして
〜を頼りに / 〜を頼り / 〜を頼りにして	〜を助けに
〜を問わず	〜に関係なく / 〜問題にしないで
〜を除いて / 〜を除き / 〜を除けば	〜を例外として / 〜以外   グループの中から、一部を除外することを表す。
〜をはじめ	〜を第一に   代表的なものを１つ「〜をはじめ」でピックアップし、それから、他の同じグループのものを言うときに使う。
～をめぐって	〜について   どんな議論や争い、意見の対立が起きているのかを説明するときに使う表現。
Nをもとに / もとにして	～を素材／基本／基準／参考にして
〜のだから / 〜んだから	〜なので   理由は話し手も聞き手も知っていること。その上で、話し手の判断を言う時や相手へ確認する時に使う。
